{
    "tiles": [
        [9,  2,  1,  1,  4,  4,  1,  6,  2,  10, 2,  2,  2,  2,  2,  2,  2,  2,  2,  2,  2,  2,  2,  2,  2,  2,  1,  0,  0,  0,  0,  1],
        [2,  6,  1,  0,  4,  4,  0,  0,  2,  2,  2,  2,  2,  2,  2,  2,  2,  2,  2,  2,  2,  2,  2,  2,  2,  2,  1,  0,  0,  0,  0,  1],
        [6,  1,  0,  0,  4,  4,  0,  0,  8,  8,  2,  2,  2,  2,  2,  2,  2,  2,  2,  2,  2,  2,  2,  2,  2,  2,  2,  0,  0,  0,  1,  1],
        [0,  0,  0,  0,  4,  4,  0,  0,  0,  9,  2,  2,  2,  2,  2,  2,  2,  2,  2,  2,  2,  2,  2,  2,  2,  2,  2,  1,  0,  0,  1,  1],
        [0,  3,  0,  0,  4,  4,  4,  4,  4,  4,  0,  0,  0,  2,  0,  2,  2,  2,  2,  2,  2,  2,  2,  2,  2,  2,  2,  2,  0,  0,  1,  1],
        [3,  3,  0,  0,  4,  4,  0,  0,  0,  0,  0,  0,  0,  2,  2,  2,  2,  2,  2,  2,  2,  2,  2,  2,  2,  2,  2,  2,  0,  0,  1,  1],
        [3,  0,  0,  0,  4,  4,  4,  4,  4,  0,  0,  0,  0,  2,  2,  2,  2,  2,  2,  2,  2,  2,  2,  2,  2,  2,  2,  2,  0,  0,  0,  1],
        [3,  0,  0,  0,  4,  4,  0,  4,  4,  0,  0,  0,  0,  2,  2,  2,  2,  2,  2,  2,  2,  2,  2,  2,  2,  2,  2,  2,  0,  0,  0,  1],
        [11, 11, 12, 11, 3,  3,  11, 12, 11, 0,  11, 2,  11, 11, 13, 2,  2,  2,  2,  2,  2,  2,  2,  2,  2,  2,  2,  2,  1,  0,  0,  1],
        [3,  7,  3,  3,  3,  3,  3,  3,  7,  0,  3,  3,  3,  3,  2,  2,  2,  2,  2,  2,  2,  2,  2,  2,  2,  2,  2,  2,  1,  0,  0,  1],
        [7,  1,  7,  7,  3,  3,  7,  7,  1,  1,  7,  1,  1,  1,  2,  2,  2,  2,  2,  2,  2,  2,  2,  2,  2,  2,  2,  2,  1,  0,  0,  1],
        [1,  1,  1,  7,  3,  7,  1,  1,  1,  1,  1,  1,  1,  2,  2,  2,  2,  2,  2,  2,  11, 11, 12, 13, 2,  2,  2,  2,  2,  0,  0,  1],
        [1,  1,  1,  1,  7,  1,  1,  1,  1,  1,  1,  1,  1,  2,  2,  2,  2,  2,  2,  2,  7,  3,  3,  3,  2,  2,  2,  2,  2,  0,  0,  1],
        [1,  1,  1,  1,  7,  1,  1,  1,  1,  1,  1,  1,  2,  2,  2,  2,  2,  2,  2,  2,  2,  7,  2,  2,  2,  2,  2,  2,  2,  0,  0,  2],
        [11, 11, 12, 11, 12, 11, 11, 12, 11, 11, 11, 1,  2,  2,  2,  2,  2,  2,  2,  2,  2,  2,  2,  2,  2,  2,  2,  2,  2,  0,  0,  2],
        [7,  7,  3,  3,  7,  7,  7,  3,  7,  3,  3,  1,  6,  2,  2,  2,  2,  2,  2,  2,  2,  2,  2,  2,  2,  2,  2,  2,  2,  0,  0,  0],
        [1,  1,  7,  7,  1,  1,  1,  7,  1,  7,  1,  1,  1,  6,  6,  2,  2,  2,  2,  2,  2,  2,  2,  2,  2,  2,  2,  2,  2,  2,  0,  0],
        [1,  1,  1,  1,  1,  1,  1,  1,  1,  1,  1,  1,  1,  1,  1,  2,  2,  2,  2,  2,  2,  2,  2,  2,  2,  2,  2,  2,  2,  2,  1,  0],
        [1,  1,  1,  1,  1,  1,  1,  1,  1,  1,  1,  1,  1,  1,  1,  6,  6,  6,  2,  2,  2,  2,  11, 2,  2,  2,  2,  2,  2,  2,  2,  1],
        [1,  1,  1,  1,  1,  1,  1,  1,  1,  1,  1,  1,  1,  1,  1,  1,  1,  1,  6,  6,  6,  6,  2,  2,  2,  2,  2,  2,  2,  2,  2,  2],
        [1,  1,  1,  1,  1,  1,  1,  1,  1,  1,  1,  1,  1,  1,  1,  1,  1,  1,  1,  1,  1,  1,  2,  2,  2,  2,  2,  2,  2,  2,  2,  2],
        [1,  1,  1,  1,  1,  1,  1,  1,  1,  1,  1,  3,  3,  1,  1,  1,  1,  1,  1,  1,  1,  1,  6,  2,  2,  2,  2,  2,  2,  2,  2,  2],
        [1,  1,  1,  1,  1,  1,  2,  1,  1,  1,  1,  1,  7,  1,  1,  1,  1,  1,  1,  1,  1,  1,  1,  2,  2,  2,  2,  2,  2,  2,  2,  2],
        [1,  1,  1,  2,  1,  2,  2,  2,  1,  1,  1,  1,  1,  1,  1,  1,  1,  1,  1,  1,  1,  1,  1,  2,  2,  2,  2,  2,  2,  2,  2,  2],
        [1,  1,  1,  2,  2,  2,  2,  2,  2,  1,  1,  1,  1,  1,  1,  1,  1,  1,  1,  1,  1,  1,  1,  6,  2,  2,  2,  2,  2,  2,  2,  2],
        [1,  1,  1,  2,  2,  2,  0,  0,  2,  1,  1,  1,  1,  1,  1,  1,  1,  1,  1,  1,  1,  11, 12, 11, 11, 11, 13, 2,  2,  2,  2,  2],
        [1,  1,  1,  2,  2,  0,  0,  0,  2,  1,  1,  1,  1,  1,  1,  3,  1,  1,  1,  1,  1,  3,  3,  7,  7,  6,  6,  2,  6,  6,  6,  6],
        [1,  1,  1,  6,  6,  0,  0,  0,  6,  1,  1,  1,  1,  1,  3,  3,  3,  1,  1,  1,  1,  1,  1,  1,  1,  1,  1,  1,  1,  1,  1,  1],
        [1,  1,  1,  1,  0,  0,  0,  0,  1,  1,  1,  1,  3,  3,  3,  3,  3,  3,  1,  1,  1,  1,  1,  1,  1,  1,  1,  1,  1,  1,  1,  1],
        [1,  1,  1,  1,  0,  0,  1,  1,  1,  1,  1,  1,  7,  3,  7,  3,  1,  7,  1,  1,  1,  1,  1,  1,  1,  1,  1,  1,  1,  1,  1,  1],
        [1,  1,  1,  1,  1,  1,  1,  1,  1,  1,  1,  1,  1,  1,  1,  7,  1,  1,  1,  1,  1,  1,  1,  1,  1,  1,  1,  1,  1,  1,  1,  1],
        [1,  1,  1,  1,  1,  1,  1,  1,  1,  1,  1,  1,  1,  1,  1,  1,  1,  1,  1,  1,  1,  1,  1,  1,  1,  1,  1,  1,  1,  1,  1,  1]
    ]
}
